NO ./path_to_the_north_texture1.xpm
SO ./path_to_the_south_texture2.xpm
WE ./path_to_the_west_texture3.xpm
EA ./path_to_the_east_texture4.xpm

F 255,0,255
C 255,30,255


        1111111111111111111111111
        1000000000110000000000001
        1011000001110000000000001
        1001000000000000000000001
111111111011000001110000000000001
100000000011000001110111111111111
11110111111111011100000010001
11110111111111011101010010001
11000000110101E11100000010001
10000000000000001100000010001
10000000000000001101010010001
11000001110101011111011110001
11110111 1110101 111111110001
11111111 1111111 111111111111
