NO ./path_to_the_north_texture1.xpm
SO ./path_to_the_south_texture2
WE ./path_to_the_west_texture3.xpm
EA ./path_to_the_east_texture4.xpm

F 0,255,0
C 0,255,0



11111111111
11111110111
111110101
1100111011
1100111011
110111011
11000111011
110111011
1100111011
11111111
