NO ./path_to_the_north_texture1.xpm
SO ./path_to_the_south_texture2.xpm
WE ./path_to_the_west_texture3.xpm
EA ./path_to_the_east_texture4.xpm

F 103,159,90
C 0,127,255


111111111111111
100000000000001
100000000000001
100000000000001
1000111110000D1
10E011111000001
100011111000001
100000000000001
100000000000001
100000000000001
111111111111111
