NO ./textures/redstone.xpm
SO ./textures/redstone.xpm
WE ./textures/redstone.xpm
EA ./textures/redstone.xpm

F 1,1,1
C 0,255,0


        1111111111111111111111111
        1111111111111112121111111
        1111111111111113431111111
        1000000000210000000000001
        1011000001110000000000001
        1002000000000000000000001
111111111011000001110111111111111
120000000011000001110122666611111
1111011111111101111001 1000400061
1111011111212101001101113000611
110000011111110111110100600061
120000001    1002100E000300061
120000001    10210101004000611111111111111111
110000011111110111210122600061
11111111 1212121 1112111600061
11111111 1111111 1111111666661
11111111 1111111 1111011111111
1111111111111111111111
