NO ./textures/redstone.xpm
SO ./textures/redstone.xpm
WE ./textures/redstone.xpm
EA ./textures/redstone.xpm

F 1,1,1
C 0,255,0


        1111111111111111111111111
        1111111111111112121111111
        1111111111111113431111111
        1000000000210000000000001
        1011000001110000000000001
        1002000000000000000000001
111111111011000001110111111111111
120000000011000001110122666611111
1111011111111101111001 10004000611
11110111112121010011011130006111
110000011101010111110100600061
12000000000000002100E000300061
120000000000000021010100400061
110000011101010111210122600061
11111111 1212121 1112111600061
11111111 1111111 1111111666661
11111111 1111111 1111011111111
1111111111111111111111
