NO ./textures/eagle.xpm
SO ./textures/redstone.xpm
WE ./textures/eagle.xpm
EA ./textures/eagle.xpm

F 80,80,80
C 46,0,108


        1111111111111111111111111
        1000000000110000000000001
        1011000001110000000S00001
        1001000000000000000000001
111111111011000001110000000000001
1000000000110000011101111121111111
11110111111111011100000010001
11110111111111011101010010001
11000000110101011100000010001
10000000000000001100000010001
10000000000000001101010010001
11000001110101011111011110001
11110111 1110101 111111110001
11111111 1111111 111111111111
