NO ./textures/redstone.xpm
SO ./textures/redstone.xpm
WE ./textures/redstone.xpm
EA ./textures/redstone.xpm

F 80,80,80
C 46,0,108


        1111111111111111111111111
        1111111111111112121111111
        1111111111111113431111111
        1000000000210000000000001
        1011000001110000000000001
        1002000000000000000000001
111111111011000001110111111111111
120000000011000001110122111111111
11110111111111011100000040001
11110111112121011101010030001
11000001110101011101010030001
12000000000000002100E00030001
12000000000000002101010040001
11000001110101011121012210001
11111111 1212121 111211110001
11111111 1111111 111111111111
