NO ./textures/redstone.xpm
SO ./textures/redstone.xpm
WE ./textures/redstone.xpm
EA ./textures/redstone.xpm

F 80,80,80
C 46,0,108


        1111111111111111111111111
        1000000000110000000000001
        1011000001110000000000001
        1001000000000000000000001
111111111011000001110000000000001
100000000011000001110111111111111
11110111111111011100000010001
11110111111111011101010010001
110000001101010111000000D0001
10000000000000001100000010001
10000000000000001101010010001
1100S001110101011111011110001
11110111 1110101 111111110001
11111111 1111111 111111111111
