NO ./textures/42logo.xpm
SO ./textures/imac.xpm
WE ./textures/kali.xpm
EA ./textures/plinux.xpm




F 0,0,0
C 0,120,200


        1111111111111111111111111
        1111111111111112121111111
        1111111111111113431111111
        1000000000210000000000001
        1011000001110000000000001
        1002000000000000000000001
111111111011000001110111111111111111
120000000011000001110122666611111111
1111011111111101111001 100040006111
111101111121210100110111300061111111111111111
110000011111110111110100600000000000000000001
120000001    1002100E000300061111111111111111
120000001    10210101004000611111111111111111
110000011111110111210122600061
11111111 1212121 1112111600061
11111111 1111111 1111111666661
11111111 1111111 1101111111111
11111111111111111111
