NO ./textures/redstone.xpm
SO ./textures/redstone.xpm
WE ./textures/redstone.xpm
EA ./textures/redstone.xpm

F 80,80,80
C 46,0,108


1111111
1000001
1004001
1030001
1000001
10N0201
1002001
1000001
1666661
1111111
